NO textures/test/north.xpm
SO textures/test/south.xpm
WE textures/test/west.xpm
EA textures/test/east.xpm

F 255, 0, 0
C 0, 0, 255

111111111111
100000000011
100000000001
110111111111
10S000000001
101111111111
100000000001
111111111111
